000 000 000 000 000 000 000 000 000 000 000 000 000 000 000 000 000 000 000 000 000 300 300 300 300 300 300 300 300 300 300 300 300 300 300 300 300 300 300 300 300 300 
000 000 000 000 000 000 000 000 000 000 000 000 000 000 000 000 000 000 000 000 000 300 300 300 300 300 300 300 300 300 300 300 300 300 300 300 300 300 300 300 300 300 
000 000 000 000 000 000 000 000 000 000 000 000 000 000 000 000 000 000 000 000 000 300 300 300 300 300 300 300 300 300 300 300 300 300 300 300 300 300 300 300 300 300 
000 000 000 000 000 000 000 000 000 000 000 000 000 000 000 000 000 000 000 000 000 300 300 300 300 300 300 300 300 300 300 300 300 300 300 300 300 300 300 300 300 300 
000 000 000 000 155 000 000 000 000 000 000 000 000 000 000 000 000 000 000 000 000 300 300 300 300 300 300 300 300 300 300 300 300 300 300 300 300 300 300 300 300 300 
000 000 000 000 000 000 000 000 000 000 000 000 000 000 000 000 000 000 000 000 000 300 300 300 300 300 300 300 300 300 300 300 300 300 300 300 300 300 300 300 300 300 
000 000 000 000 000 000 000 000 000 000 000 000 000 000 000 000 000 000 000 000 000 300 300 300 300 300 300 300 300 300 300 300 300 300 300 300 300 300 300 300 300 300 
000 000 000 000 000 000 000 000 000 000 000 000 000 000 000 000 000 000 000 000 000 300 300 300 300 300 300 300 300 300 300 300 300 300 300 300 300 300 300 300 300 300 
000 000 000 000 000 000 000 000 000 000 000 000 000 000 000 000 000 000 000 000 000 300 300 300 300 300 300 300 300 300 300 300 300 300 300 300 300 300 300 300 300 300 
000 000 000 000 000 000 000 000 000 000 000 000 000 000 000 000 000 000 000 000 000 300 300 300 300 300 300 300 300 300 300 300 300 300 300 300 300 300 300 300 300 300 
000 000 000 000 000 000 000 000 000 000 000 000 000 000 000 000 000 000 000 000 000 300 300 300 300 300 300 300 300 300 300 300 300 300 300 300 300 300 300 300 300 300 
000 000 000 000 000 000 000 000 000 000 000 000 000 000 000 000 000 000 000 000 000 300 300 300 300 300 300 300 300 300 300 300 300 300 300 300 300 300 300 300 300 300 
000 000 000 000 000 000 000 000 000 000 000 000 000 000 000 000 000 000 000 000 000 300 300 300 300 300 300 300 300 300 300 300 300 300 300 300 300 300 300 300 300 300 
000 000 000 000 000 000 000 000 000 000 000 000 000 000 000 000 000 000 000 000 000 300 300 300 300 300 300 300 300 300 300 300 300 300 300 300 300 300 300 300 300 300 
000 000 000 000 000 000 000 000 000 000 000 000 000 000 000 000 000 000 000 000 000 300 300 300 300 300 300 300 300 300 300 300 300 300 300 300 300 300 300 300 300 300 
000 000 000 000 000 000 000 000 000 000 000 000 000 000 000 000 000 000 000 000 000 300 300 300 300 300 300 300 300 300 300 300 300 300 300 300 300 300 300 300 300 300 
000 000 000 000 000 000 000 000 000 000 000 000 000 000 000 000 000 000 000 000 000 300 300 300 300 300 300 300 300 300 300 300 300 300 300 300 300 300 300 300 300 300 
000 000 000 000 000 000 000 000 000 000 000 000 000 000 000 000 000 000 000 000 000 300 300 300 300 300 300 300 300 300 300 300 300 300 300 300 300 300 300 300 300 300 
000 000 000 000 000 000 000 000 000 000 000 000 000 000 000 000 000 000 000 000 000 000 000 000 000 000 000 000 000 000 000 000 000 000 000 000 000 000 000 000 000 000 
000 000 000 000 000 000 000 000 000 000 000 000 000 000 000 000 000 000 000 000 000 000 000 000 000 000 000 000 000 000 000 000 000 000 000 000 000 000 000 000 000 000 
000 000 000 000 000 000 000 000 000 000 000 000 000 000 000 000 000 000 000 000 000 000 000 000 000 000 000 000 000 000 000 000 000 000 000 000 000 000 000 000 000 000 
300 300 300 300 300 300 300 300 300 300 300 300 300 300 300 300 300 300 300 300 000 000 000 000 000 000 000 000 000 000 000 000 000 000 000 000 000 000 000 000 000 000 
300 300 300 300 300 300 300 300 300 300 300 300 300 300 300 300 300 300 300 300 000 000 000 000 000 000 000 000 000 000 000 000 000 000 000 000 000 000 000 000 000 000 
300 300 300 300 300 300 300 300 300 300 300 300 300 300 300 300 300 300 300 300 000 000 000 000 000 000 000 000 000 000 000 000 000 000 000 000 000 000 000 000 000 000 
300 300 300 300 300 300 300 300 300 300 300 300 300 300 300 300 300 300 300 300 000 000 000 000 000 000 000 000 000 000 000 000 000 000 000 000 000 000 000 000 000 000 
300 300 300 300 300 300 300 300 300 300 300 300 300 300 300 300 300 300 300 300 000 000 000 000 000 000 000 000 000 000 000 000 000 000 000 000 000 000 000 000 000 000 
300 300 300 300 300 300 300 300 300 300 300 300 300 300 300 300 300 300 300 300 000 000 000 000 000 000 000 000 000 000 000 000 000 000 000 000 000 000 000 000 000 000 
300 300 300 300 300 300 300 300 300 300 300 300 300 300 300 300 300 300 300 300 000 000 000 000 000 000 000 000 000 000 000 000 000 000 000 000 000 000 000 000 000 000 
300 300 300 300 300 300 300 300 300 300 300 300 300 300 300 300 300 300 300 300 000 000 000 000 000 000 000 000 000 000 000 000 000 000 000 000 000 000 000 000 000 000 
300 300 300 300 300 300 300 300 300 300 300 300 300 300 300 300 300 300 300 300 000 000 000 000 000 000 000 000 000 000 000 000 000 000 000 000 000 000 000 000 000 000 
300 300 300 300 300 300 300 300 300 300 300 300 300 300 300 300 300 300 300 300 000 000 000 000 000 000 000 000 000 000 000 000 000 000 000 000 000 000 000 000 000 000 
300 300 300 300 300 300 300 300 300 300 300 300 300 300 300 300 300 300 300 300 000 000 000 000 000 000 000 000 000 000 000 000 000 000 000 000 000 000 000 000 000 000 
300 300 300 300 300 300 300 300 300 300 300 300 300 300 300 300 300 300 300 300 000 000 000 000 000 000 000 000 000 000 000 000 000 000 000 000 000 000 000 000 000 000 
300 300 300 300 300 300 300 300 300 300 300 300 300 300 300 300 300 300 300 300 000 000 000 000 000 000 000 000 000 000 000 000 000 000 000 000 000 000 000 000 000 000 
300 300 300 300 300 300 300 300 300 300 300 300 300 300 300 300 300 300 300 300 000 000 000 000 000 000 000 000 000 000 000 000 000 000 000 000 000 155 000 000 000 000 
300 300 300 300 300 300 300 300 300 300 300 300 300 300 300 300 300 300 300 300 000 000 000 000 000 000 000 000 000 000 000 000 000 000 000 000 000 000 000 000 000 000 
300 300 300 300 300 300 300 300 300 300 300 300 300 300 300 300 300 300 300 300 000 000 000 000 000 000 000 000 000 000 000 000 000 000 000 000 000 000 000 000 000 000 
300 300 300 300 300 300 300 300 300 300 300 300 300 300 300 300 300 300 300 300 000 000 000 000 000 000 000 000 000 000 000 000 000 000 000 000 000 000 000 000 000 000 
300 300 300 300 300 300 300 300 300 300 300 300 300 300 300 300 300 300 300 300 000 000 000 000 000 000 000 000 000 000 000 000 000 000 000 000 000 000 000 000 000 000 
300 300 300 300 300 300 300 300 300 300 300 300 300 300 300 300 300 300 300 300 000 000 000 000 000 000 000 000 000 000 000 000 000 000 000 000 000 000 000 000 000 000 
